Municipio;Codice scuola;Tipo scuola;Natura giuridica;Nome scuola;Indirizzo;Telefono;Orario entrat/uscita;Corsi attivi;Totale capienza;Totale iscritti;Iscritti maschi;Iscritti femmine;Piccoli;Medi;Grandi;Iscritti > 48 mesi;Iscritti <= 48 mesi;Iscritti italiani;Iscritti non italiani
I;3557;INFANZIA;COMUNALE;A. BACCARINI;Via Sforza, 2;06/4883788;08:00 / 17:00;3;75;62;31;31;0;0;0;31;31;32;30
I;3549;INFANZIA;COMUNALE;A. CADLOLO ;Via Della Rondinella, 2;06/68802521;08:00 / 17:00;4;100;94;47;47;0;0;0;52;42;93;1
I;3553;INFANZIA;COMUNALE;E.GIANTURCO;Via Della Palombella, 4;06/68307753;08:00 / 17:00;3;63;59;23;36;0;0;0;32;27;51;8
I;3556;INFANZIA;COMUNALE;E.PESTALOZZI;Via Mentana, 1;06/4941465;08:00 / 17:00;2;50;43;22;21;0;0;0;20;23;30;13
I;3554;INFANZIA;COMUNALE;E.RUSPOLI;Via Di Gesu' E Maria, 28;06/3614185;08:00 / 17:00;2;50;43;25;18;0;0;0;19;24;34;9
I;3558;INFANZIA;COMUNALE;F. DI DONATO ;Via Conte Verde, 47;06/77071922;07:00 / 17:00;3;75;73;40;33;0;0;0;40;33;59;14
I;3551;INFANZIA;COMUNALE;G. MAMELI ;Via Dei Genovesi, 30;06/5816462;07:30 / 17:00;3;75;59;30;29;0;0;0;32;27;53;6
I;3550;INFANZIA;COMUNALE;G.G. BADINI;Piazza Di S. Alessio, 34;06/5742051;08:00 / 17:00;4;90;88;48;40;0;0;0;46;42;85;3
I;3548;INFANZIA;COMUNALE;G.GRILLI;Piazzale Anita Garibaldi, 2;06/6892932;08:00 / 17:00;1;25;25;11;14;0;0;0;12;13;25;0
I;6422;INFANZIA;COMUNALE;GIARDINIERI;Via Di Porta S. Sebastiano, 2;06/70492990;08:00 / 16:30;3;60;59;35;24;0;0;0;36;23;59;0
I;3552;INFANZIA;COMUNALE;LA SCALA;Piazza Della Scala, 22;06/5809205;08:00 / 17:00;3;75;74;36;38;0;0;0;37;37;70;4
I;2648;INFANZIA;COMUNALE;LEOPOLDO FRANCHETTI ;Piazza Gian Lorenzo Bernini, 26;06/5743041;07:30 / 17:00;4;96;94;46;48;0;0;0;55;39;85;9
I;3555;INFANZIA;COMUNALE;L.SETTEMBRINI;Via Del Lavatore, 38;06/6787508;08:00 / 17:00;2;50;46;20;26;0;0;0;24;22;34;12
I;2642;INFANZIA;COMUNALE;PAOLA BIOCCA ;Via Galvani, 4B;06/5750864;08:00 / 17:00;6;137;128;60;68;0;0;0;63;65;109;19
I;3559;INFANZIA;COMUNALE;RUGGERO BONGHI;Via Ruggero Bonghi, 30;06/70453718;08:00 / 17:00;5;125;114;64;50;0;0;0;68;46;78;36
I;3546;INFANZIA;COMUNALE;TRENTO E TRIESTE;Via Dei Giubbonari, 41;06/68308049;08:00 / 17:00;2;50;42;21;21;0;0;0;23;19;35;7
I;2645;INFANZIA;COMUNALE;UN TEMPO LINEARE PER IL BAMBINO E LA FAMIGLIA DA 3 A 6 ANNI;Via Marmorata, 169;06/57139488;08:00 / 13:20;2;28;24;13;11;0;0;0;13;11;23;1
II;2783;INFANZIA;COMUNALE;COLORI DEL MONDO;Via Adigrat, 2;06/86325932;08:00 / 17:00;3;75;73;51;22;0;0;0;39;34;54;19
II;3541;INFANZIA;COMUNALE;CONTARDO FERRINI;Via Di Villa Chigi, 22;06/86212459;08:00 / 17:00;9;193;193;104;89;0;0;0;117;76;178;15
II;3564;INFANZIA;COMUNALE;GIARDINO INCANTATO;Via Pinciana, 10;06/8554697;08:00 / 17:00;4;83;82;52;30;0;0;0;53;29;80;2
II;2752;INFANZIA;COMUNALE;GIUSEPPE MAZZINI;Via Volsinio, 25;06/86386973;08:00 / 17:00;10;250;250;120;130;0;0;0;144;106;237;13
II;2777;INFANZIA;COMUNALE;GRAZIOLI LANTE DELLA ROVERE;Via Tevere, 22;06/85350344;08:00 / 17:00;2;50;50;27;23;0;0;0;31;19;48;2
II;2748;INFANZIA;COMUNALE;GUGLIELMINA RONCONI;Via Pietro Antonio Micheli, 21;06/3221254;08:00 / 17:00;7;175;133;63;70;0;0;0;71;62;106;27
II;3539;INFANZIA;COMUNALE;GUIDO ALESSI;Via Flaminia, 225;06/3226539;08:00 / 17:00;6;145;143;82;61;0;0;0;87;56;131;12
II;2782;INFANZIA;COMUNALE;I SEI COLORI DI UGO;Via Tigre', 96;06/86208391;08:00 / 17:00;6;128;127;74;53;0;0;0;78;49;109;18
II;3537;INFANZIA;COMUNALE;IL GIRAMONDO;Via Venezuela, 33;06/8086136;08:00 / 17:00;4;80;78;45;33;0;0;0;44;34;70;8
II;2753;INFANZIA;COMUNALE;L'ALBERO AZZURRO;Via Novara, 22;06/8557507;08:00 / 17:00;4;100;100;57;43;0;0;0;63;37;91;9
II;2779;INFANZIA;COMUNALE;PRINCIPESSA MAFALDA;Via Lovanio, 13;06/85353759;08:00 / 17:00;7;171;163;82;81;0;0;0;87;76;145;18
II;2749;INFANZIA;COMUNALE;SAN PIO X ;Via Umberto Boccioni, 14;06/8074360;08:00 / 17:00;4;73;71;40;31;0;0;0;37;34;69;2
II;2790;INFANZIA;COMUNALE;BRASILE ;Via Rodolfo Lanciani, 54;06/86216644;08:00 / 17:00;6;114;110;54;56;0;0;0;59;51;101;9
II;2785;INFANZIA;COMUNALE;FRATELLI BANDIERA ;Via Stamira, 55;06/44233003;08:30 / 17:00;9;225;209;109;100;0;0;0;100;109;176;33
II;2786;INFANZIA;COMUNALE;SAFFI;Via Dei Sardi, 35;06/4463225;08:00 / 17:00;6;142;135;75;60;0;0;0;74;61;106;29
III;2813;INFANZIA;COMUNALE;ALCIDE DE GASPERI ;Via Matteo Bandello, 30;06/95950462;08:00 / 17:00;5;117;116;54;62;0;0;0;66;50;113;3
III;3361;INFANZIA;COMUNALE;ANGELO MAURI ;Via Piero Foscari, 61;/;08:00 / 17:00;4;88;88;44;44;0;0;0;49;39;87;1
III;2809;INFANZIA;COMUNALE;ANNA MAGNANI;Via Val Maggia, 21;06/8121064;08:00 / 17:00;6;144;144;73;71;0;0;0;92;52;133;11
III;2816;INFANZIA;COMUNALE;BUENOS AIRES ;Via Renato Fucini, 265;06/8277268;08:00 / 17:00;8;180;164;85;79;0;0;0;89;75;145;19
III;2806;INFANZIA;COMUNALE;CIPI;Via Cinigiano, 50;06/95950414;08:00 / 17:00;3;69;69;30;39;0;0;0;45;24;64;5
III;2802;INFANZIA;COMUNALE;COMANO;Via Comano, 9;/;08:00 / 17:00;5;115;115;62;53;0;0;0;66;49;114;1
III;2821;INFANZIA;COMUNALE;DON BOSCO;Piazza Monte Baldo, 2;06/87183981;08:00 / 17:00;6;147;144;77;67;0;0;0;70;74;111;33
III;2818;INFANZIA;COMUNALE;GASPARA STAMPA;Via Giovanni Verga, 21;06/8273795;08:00 / 17:00;4;92;89;45;44;0;0;0;49;40;87;2
III;3562;INFANZIA;COMUNALE;GIARDINOMAGICO ;Via Rina De Liguoro, 50;/;08:00 / 17:00;6;143;142;77;65;0;0;0;85;57;135;7
III;2804;INFANZIA;COMUNALE;GIOVANNI PAOLO I ;Via Dello Scalo Di Settebagni, 45;06/8889910;08:00 / 17:00;4;84;84;44;40;0;0;0;55;29;66;18
III;2811;INFANZIA;COMUNALE;G.PARINI;Piazza Capri, 25;06/8177850;08:00 / 17:00;1;20;20;10;10;0;0;0;12;8;13;7
III;5767;INFANZIA;COMUNALE;MARCO GIANNETTI; Via Guglielmo Petroni, 24;/;08:00 / 17:00;3;75;75;43;32;0;0;0;52;23;73;2
III;2814;INFANZIA;COMUNALE;MARIA STERNUOVO ;Via Di Settebagni, 231;06/87133907;08:00 / 17:00;3;65;64;28;36;0;0;0;33;31;58;6
III;2795;INFANZIA;COMUNALE;MONTE CARDONETO ;Via Monte Cardoneto, 11;/;08:00 / 17:00;7;153;153;85;68;0;0;0;95;58;135;18
III;2796;INFANZIA;COMUNALE;MONTE MASSICO;Via Giovanni Conti, 58;06/87190354;08:00 / 17:00;3;70;70;34;36;0;0;0;41;29;63;7
III;2819;INFANZIA;COMUNALE;PALMINA TALENTI ;Via Dario Niccodemi, 95;06/87133205;08:00 / 17:00;4;90;90;41;49;0;0;0;46;44;89;1
III;6124;INFANZIA;COMUNALE;PUNTOEACAPO;Via Adolfo Celi, 95;06/87071455;08:00 / 17:00;3;75;75;45;30;0;0;0;42;33;74;1
III;2807;INFANZIA;COMUNALE;SCUOLA INSIEME;Via Seggiano, 32;/;08:00 / 17:00;3;71;70;40;30;0;0;0;36;34;69;1
III;2801;INFANZIA;COMUNALE;SORELLE TETRAZZINI;Via Sorelle Tetrazzini, 55;/;08:00 / 17:00;3;75;75;41;34;0;0;0;45;30;69;6
III;2803;INFANZIA;COMUNALE;TITINA DE FILIPPO;Viale Titina De Filippo, 156;06/8818194;08:00 / 17:00;4;100;100;56;44;0;0;0;50;50;87;13
III;2810;INFANZIA;COMUNALE;VAL DI LANZO;Via Val Di Lanzo, 108;/;08:00 / 17:00;5;125;124;60;64;0;0;0;64;60;114;10
III;2822;INFANZIA;COMUNALE;VALDARNO;Via Valdarno, 6;/;08:00 / 17:00;5;117;117;67;50;0;0;0;58;59;103;14
III;2797;INFANZIA;COMUNALE;WALT DISNEY ;Piazza Luigi Porro Lambertenghi, 14;06/87136928;08:00 / 17:00;4;80;80;36;44;0;0;0;54;26;78;2
IV;2848;INFANZIA;COMUNALE;A. TORRE ;Via Andrea Torre, 15;06/4513488;08:00 / 17:00;7;130;130;71;59;0;0;0;74;56;111;19
IV;2824;INFANZIA;COMUNALE;CASAL BIANCO ; Via Di Casal Bianco, 136;06/4190431;08:00 / 17:00;3;60;60;24;36;0;0;0;27;33;52;8
IV;3851;INFANZIA;COMUNALE;CASALE AZZURRO EX CASALMONASTERO;Via Poppea Sabina, 91;06/41294444;08:00 / 17:00;3;75;75;41;34;0;0;0;45;30;72;3
IV;2825;INFANZIA;COMUNALE;CASE ROSSE ;Via Corropoli, 133;06/41294197;08:00 / 17:00;5;115;115;58;57;0;0;0;69;46;103;12
IV;3718;INFANZIA;COMUNALE;CECCHINA AGUZZANO ;Via Cartesio, 3;06/8271272;08:00 / 17:00;4;100;81;47;34;0;0;0;45;36;79;2
IV;2832;INFANZIA;COMUNALE;CIAMICIAN ;Via Giacomo Ciamician, 32;06/40819539;08:00 / 17:00;3;60;60;33;27;0;0;0;32;28;43;17
IV;2836;INFANZIA;COMUNALE;COLLI ANIENE FRANCESCHINI;Via Fausto Gullo, 32;06/4063308;08:00 / 17:00;4;100;100;34;66;0;0;0;51;49;100;0
IV;3719;INFANZIA;COMUNALE;FABIO FILZI ;Via Del Frantoio, 46;06/4076335;08:00 / 17:00;4;72;70;31;39;0;0;0;36;34;61;9
IV;2839;INFANZIA;COMUNALE;GROTTE DI GREGNA ;Via Augusto Mammucari, 35;06/4065681;08:00 / 17:00;4;100;99;53;46;0;0;0;55;44;97;2
IV;2846;INFANZIA;COMUNALE;GUIDO DE RUGGIERO ;Via Achille Tedeschi, 75;06/4511760;08:00 / 17:00;4;100;95;47;48;0;0;0;57;38;80;15
IV;2841;INFANZIA;COMUNALE;M. B. ALBERTI;Piazza Federico Sacco, 14;06/4502845;08:00 / 17:00;2;40;40;21;19;0;0;0;24;16;38;2
IV;2837;INFANZIA;COMUNALE;MARY POPPINS ;Via Cesare Massini, 44;06/4070388;08:00 / 17:00;4;91;91;45;46;0;0;0;49;42;91;0
IV;3850;INFANZIA;COMUNALE;MATITE COLORATE ;Piazza Paolo Rossi, 4;06/41200896;08:00 / 17:00;7;175;172;86;86;0;0;0;104;68;167;5
IV;2849;INFANZIA;COMUNALE;MESSI D'ORO;Via Gaetano Giorgio Gemmellaro, 47;06/41733886;08:00 / 17:00;7;172;164;97;67;0;0;0;96;68;152;12
IV;2831;INFANZIA;COMUNALE;PENNABILLI ;Via Pennabilli, 41;06/41224064;08:00 / 17:00;2;36;28;17;11;0;0;0;15;13;24;4
IV;2844;INFANZIA;COMUNALE;PICCININI ;Via Filippo Fiorentini, 48;06/4395116;08:00 / 17:00;7;150;150;80;70;0;0;0;84;66;147;3
IV;2834;INFANZIA;COMUNALE;PRATOLUNGO ;Via Elena Brandizzi Gianni, 48;06/4103197;08:00 / 17:00;3;70;66;38;28;0;0;0;43;23;60;6
IV;2842;INFANZIA;COMUNALE;RANDACCIO;Piazza Tommaso De Cristoforis, 8;06/4392151;08:00 / 17:00;6;150;137;75;62;0;0;0;78;59;124;13
IV;2828;INFANZIA;COMUNALE;SAN CLETO ;Via Nicola Maria Nicolai, 85;06/4102631;08:00 / 17:00;4;100;72;37;35;0;0;0;39;33;60;12
IV;2847;INFANZIA;COMUNALE;SAN ROMANO ;Via Di S. Romano, 93;06/4381166;08:00 / 17:00;9;162;147;76;71;0;0;0;79;68;126;21
IV;2823;INFANZIA;COMUNALE;SETTECAMINI ;Via Montenero Sabino, 7;06/41239462;08:00 / 17:00;5;104;104;50;54;0;0;0;65;39;93;11
IV;2826;INFANZIA;COMUNALE;SIBILLA ;Via Monte Manno, 33;06/4131102;08:00 / 17:00;4;90;90;59;31;0;0;0;51;39;88;2
IV;2835;INFANZIA;COMUNALE;SOMMOVIGO ;Via Amedeo Sommovigo, SNC;06/4070715;08:00 / 17:00;7;165;164;75;89;0;0;0;98;66;160;4
IV;2827;INFANZIA;COMUNALE;TORRACCIO ;Via Giggi Spaducci, 37;06/4111893;08:00 / 17:00;2;50;41;22;19;0;0;0;21;20;37;4
IV;2840;INFANZIA;COMUNALE;V. VENETO ;Via Pomona, 9;06/4503930;08:00 / 17:00;5;94;91;46;45;0;0;0;54;37;79;12
IV;2833;INFANZIA;COMUNALE;VILLAGGIO INA CASA ;Via Rivisondoli, 11;06/4073571;08:00 / 17:00;2;44;38;18;20;0;0;0;21;17;23;15
V;3240;INFANZIA;COMUNALE;ALESSANDRO MARCUCCI;Via Gabrino Fondulo, 58;/;08:00 / 17:00;4;71;70;39;31;0;0;0;37;33;58;12
V;3244;INFANZIA;COMUNALE;CARLO PISACANE;Via Di Acqua Bullicante, 30;/;08:00 / 17:00;7;138;133;69;64;0;0;0;81;52;70;63
V;3249;INFANZIA;COMUNALE;ENRICO TOTI;Via Del Pigneto, 104;/;08:00 / 17:00;8;161;153;74;79;0;0;0;65;88;136;17
V;3241;INFANZIA;COMUNALE;GIOVANNI XXIII;Viale Partenope, 55;/;08:00 / 17:00;8;171;162;92;70;0;0;0;99;63;142;20
V;3242;INFANZIA;COMUNALE;GIULIO CESARE;Via Conte Di Carmagnola, 27;/;08:00 / 17:00;9;225;210;98;112;0;0;0;113;97;135;75
V;3239;INFANZIA;COMUNALE;GRAZIA DELEDDA;Viale Filarete, 31;/;08:00 / 17:00;8;182;178;86;92;0;0;0;110;68;104;74
V;3245;INFANZIA;COMUNALE;I BAMBINI NEL MONDO;Via Guglielmo Degli Ubertini, 47;/;08:00 / 17:00;4;88;85;57;28;0;0;0;35;50;73;12
V;3237;INFANZIA;COMUNALE;IL GIARDINO DEI COLORI;Viale Della Venezia Giulia, 72;/;08:00 / 17:00;5;100;100;61;39;0;0;0;58;42;98;2
V;3579;INFANZIA;COMUNALE;IL PICCOLO PRINCIPE;Via Romolo Balzani, 55;/;08:00 / 17:00;5;125;101;57;44;0;0;0;56;45;90;11
V;3247;INFANZIA;COMUNALE;IL SOLE;Via Di Centocelle, 236;/;08:00 / 17:00;3;75;65;24;41;0;0;0;32;33;53;12
V;3243;INFANZIA;COMUNALE;L'ALBERO DEI BAMBINI;Piazza Giuseppe Cardinali, 1;/;08:00 / 17:00;7;151;141;68;73;0;0;0;73;68;97;44
V;3246;INFANZIA;COMUNALE;MARIANO ROMITI;Viale Della Venezia Giulia, 64;/;08:00 / 17:00;6;149;131;60;71;0;0;0;74;57;95;36
V;3580;INFANZIA;COMUNALE;TRILUSSA;Via Fiuggi, 18;/;08:00 / 17:00;8;172;151;78;73;0;0;0;64;87;118;33
V;6038;INFANZIA;COMUNALE; L'APE BIRICHINA; Via Giorgio Perlasca, 59;06/95950719;08:00 / 17:00;2;50;45;29;16;0;0;0;22;23;42;3
V;2869;INFANZIA;COMUNALE;ANDREA DORIA;Via Pietro Romualdo Pirotta, 95;06/06 95950705;08:00 / 17:00;3;75;70;34;36;0;0;0;41;29;46;24
V;6180;INFANZIA;COMUNALE;BONAFEDE;Via Francesco Bonafede, 95;06/95950718;08:00 / 17:00;2;50;42;20;22;0;0;0;24;18;33;9
V;3792;INFANZIA;COMUNALE;DALMAZIO BIRAGO;Via Collatina, 103;06/95950717;08:00 / 17:00;7;166;163;76;87;0;0;0;101;62;154;9
V;2866;INFANZIA;COMUNALE;FAUSTO CECCONI;Via Dei Glicini, 60;06/95950702;08:00 / 17:00;11;274;264;134;130;0;0;0;137;127;211;53
V;2864;INFANZIA;COMUNALE;GIOACCHINO GESMUNDO ;Piazza Cesare De Cupis, 20;06/95950701;08:00 / 17:00;9;225;214;116;98;0;0;0;132;82;148;66
V;2871;INFANZIA;COMUNALE;GUGLIELMO MARCONI ;Viale Alessandrino, 390;06/95950707;08:00 / 17:00;11;224;212;111;101;0;0;0;112;100;183;29
V;2867;INFANZIA;COMUNALE;IL VELIERO VOLANTE ;Via Michele Tenore, 15;06/95950703;08:00 / 17:00;7;153;151;79;72;0;0;0;90;61;133;18
V;2870;INFANZIA;COMUNALE;LUIGI GADOLA;Via Luigi Gadola, 31;06/95950706;08:00 / 17:00;4;100;100;47;53;0;0;0;59;41;98;2
V;2868;INFANZIA;COMUNALE;MARCO POLO ;Via Girolamo Cocconi, 10;06/95950704;08:00 / 17:00;7;175;173;109;64;0;0;0;97;76;112;61
VI;2909;INFANZIA;COMUNALE;AMICI DI PETER PAN;Via Battista Panzera, 3;06/2009676;08:00 / 17:00;6;150;147;71;76;0;0;0;67;80;106;41
VI;2874;INFANZIA;COMUNALE;ARCHIMEDE;Via Siculiana, 82;06/2052653;08:00 / 17:00;5;125;125;73;52;0;0;0;64;61;111;14
VI;2876;INFANZIA;COMUNALE;IL GIROTONDO;Via Motta Camastra, 155D;06/20765186;08:00 / 17:00;5;125;125;67;58;0;0;0;77;48;93;32
VI;2908;INFANZIA;COMUNALE;IL GRILLO PARLANTE;Via Agostino Mitelli, 8;06/20686525;08:00 / 17:00;4;100;100;50;50;0;0;0;53;47;84;16
VI;2912;INFANZIA;COMUNALE;LA COLLINA DEGLI ULIVI;Via Della Stazione Di Colle Mattia, SNC;06/20609222;08:00 / 13:00;2;50;42;18;24;0;0;0;11;31;34;8
VI;2910;INFANZIA;COMUNALE;LA MONGOLFIERA;Via Degli Orafi, 30;06/2024484;08:00 / 17:00;3;75;75;28;47;0;0;0;45;30;72;3
VI;2873;INFANZIA;COMUNALE;LA TROTTOLA;Via Emiliano Degli Orfini, 52;06/2024422;08:00 / 17:00;3;75;74;36;38;0;0;0;41;33;66;8
VI;2877;INFANZIA;COMUNALE;L'ARCOBALENO DEI BAMBINI;Via Di Rocca Cencia, 39;06/20763770;08:00 / 17:00;3;75;75;33;42;0;0;0;46;29;40;35
VI;2911;INFANZIA;COMUNALE;LEA BIAGINI;Piazzale Delle Paradisee, 9;06/262534;08:00 / 17:00;3;75;75;36;39;0;0;0;39;36;69;6
VI;2875;INFANZIA;COMUNALE;L'ISOLACHENONC'E';Via Tudia, 16;06/20760877;08:00 / 17:00;3;60;60;30;30;0;0;0;37;23;54;6
VI;5838;INFANZIA;COMUNALE;MAGO MERLINO;Via Acquaroni, 53;06/45606982;08:00 / 17:00;3;75;75;44;31;0;0;0;45;30;59;16
VI;2872;INFANZIA;COMUNALE;MONDOLANDIA;Via Della Tenuta Di Torrenova, 134;06/2024588;08:00 / 17:00;5;125;125;65;60;0;0;0;76;49;106;19
VI;6423;INFANZIA;COMUNALE;PATERNO';Via Paterno', 24;/;NULL;2;40;40;18;22;0;0;0;18;22;31;9
VI;6418;INFANZIA;COMUNALE;PRAMPOLINI;Via Natale Prampolini, 9;/;08:00 / 17:00;3;75;75;33;42;0;0;0;57;18;74;1
VI;5636;INFANZIA;COMUNALE;PRATO FIORITO;Viale Prato Fiorito, 58;06/2252894;08:00 / 16:30;4;100;100;46;54;0;0;0;64;36;91;9
VI;4009;INFANZIA;COMUNALE;SCARPE SCIOLTE;Via Guido Corbellini, 28;06/22450601;08:00 / 17:00;7;175;175;101;74;0;0;0;124;51;157;18
VI;3604;INFANZIA;COMUNALE;SIMPATICHE CANAGLIE;Via Luigi Gastinelli, 36;06/22188800;08:00 / 17:00;6;150;151;77;74;0;0;0;115;36;141;10
VI;5640;INFANZIA;COMUNALE;TRILLI;Via Paterno', 20;06/45569760;08:00 / 13:00;3;62;62;29;33;0;0;0;35;27;57;5
VII;2924;INFANZIA;COMUNALE;ADA NEGRI;Via Latina, 303;06/7883001;08:00 / 17:00;10;229;222;115;107;0;0;0;129;93;215;7
VII;2921;INFANZIA;COMUNALE;ALESSANDRO MANZONI;Via Populonia, 41;06/77079294;08:00 / 17:00;10;209;205;108;97;0;0;0;127;78;194;11
VII;3127;INFANZIA;COMUNALE;ARMANDO DIAZ;Via Acireale, 2;06/70301600;08:00 / 17:00;6;118;116;57;59;0;0;0;68;48;113;3
VII;2918;INFANZIA;COMUNALE;BOBBIO;Via Bobbio, 3;06/7027448;08:00 / 17:00;3;60;59;31;28;0;0;0;38;21;55;4
VII;3603;INFANZIA;COMUNALE;GIANNI RODARI;Via Norcia, 19;06/786483;08:00 / 17:00;10;215;204;104;100;0;0;0;112;92;198;6
VII;2919;INFANZIA;COMUNALE;GIOSUE' CARDUCCI;Via La Spezia, 21;06/7008165;08:00 / 17:00;5;109;104;50;54;0;0;0;53;51;94;10
VII;3129;INFANZIA;COMUNALE;GIOVANNI CAGLIERO;Largo Volumnia, 11;06/7842404;08:00 / 17:00;7;156;138;71;67;0;0;0;84;54;117;21
VII;2922;INFANZIA;COMUNALE;GIUSEPPE GARIBALDI;Via Mondovi', 16;06/7017465;08:00 / 17:00;7;175;145;81;64;0;0;0;72;73;121;24
VII;3134;INFANZIA;COMUNALE;GIUSEPPE VERDI ;Via Gela, 22;06/7018488;08:00 / 17:00;8;181;168;79;89;0;0;0;96;72;146;22
VII;2926;INFANZIA;COMUNALE;SALVATORE QUASIMODO;Via Latina, 550;06/7801755;08:00 / 17:00;5;105;94;44;50;0;0;0;48;46;80;14
VII;2927;INFANZIA;COMUNALE;TEODORO MOMMSEN;Via Franco Bartoloni, 90;06/7809924;08:00 / 17:00;4;80;78;43;35;0;0;0;41;37;76;2
VII;2925;INFANZIA;COMUNALE;VILLA LAZZARONI;Via Appia Nuova, 522;06/7880350;08:00 / 17:00;8;173;168;86;82;0;0;0;96;72;151;17
VII;3385;INFANZIA;COMUNALE;ALDO FABRIZI;Via Valerio Publicola, 165;06/7615382;08:00 / 17:00;6;136;136;72;64;0;0;0;81;55;123;13
VII;3400;INFANZIA;COMUNALE;ARRIGO FAZIO;Via Tuscolana, 1111;06/7222445;08:00 / 17:00;2;40;40;17;23;0;0;0;15;25;29;11
VII;5527;INFANZIA;COMUNALE;BARCACCIA;Via Enzo Paci, 8;06/45510064;08:00 / 16:30;3;75;74;28;46;0;0;0;43;31;70;4
VII;3397;INFANZIA;COMUNALE;CARLO FADDA;Via Carlo Fadda, 124;06/7221436;08:30 / 17:00;2;50;49;29;20;0;0;0;32;17;43;6
VII;3390;INFANZIA;COMUNALE;CENTRONI; Via Del Fosso Di S. Andrea, 67;06/79847260;08:00 / 17:00;9;225;222;110;112;0;0;0;117;105;205;17
VII;3401;INFANZIA;COMUNALE;COLORARTE;Via Edoardo Martini, 8;06/7210245;08:00 / 17:00;4;98;90;44;46;0;0;0;48;42;85;5
VII;3388;INFANZIA;COMUNALE;DAMIANO CHIESA;Via Egerio Levio, 2;06/76963218 - 45423473;08:00 / 17:00;7;175;174;84;90;0;0;0;95;79;119;55
VII;3387;INFANZIA;COMUNALE;DON MICHELE RUA;Via Giuseppe Belloni, 30;06/71587015;08:30 / 16:30;5;108;108;54;54;0;0;0;70;38;90;18
VII;3391;INFANZIA;COMUNALE;FARO DEI BIMBI ;Via Niobe, 50;06/79810127;08:00 / 17:00;6;128;128;67;61;0;0;0;68;60;107;21
VII;3389;INFANZIA;COMUNALE;FONTANILE ANAGNINO;Via Del Fontanile Anagnino, 123;06/7900190;08:00 / 17:00;9;220;220;101;119;0;0;0;123;97;204;16
VII;3402;INFANZIA;COMUNALE;GERMOGLIO DELLE IDEE (EX P. MARCHISIO);Via Pietro Marchisio, 188;06/7216317;08:00 / 17:00;5;113;111;50;61;0;0;0;56;55;107;4
VII;3398;INFANZIA;COMUNALE;GIACOMO PUCCINI;Viale Dei Consoli, 16;06/7141484;08:00 / 17:00;3;75;75;36;39;0;0;0;45;30;60;15
VII;3393;INFANZIA;COMUNALE;GREGNA SANT'ANDREA;Via Alessandro Della Seta, 8;06/72671435;08:00 / 17:00;5;125;125;69;56;0;0;0;69;56;107;18
VII;3403;INFANZIA;COMUNALE;L'ALLEGRA BRIGATA (EX C. VECCHI);Via Cisberto Vecchi, 21;06/7223513;08:00 / 17:00;3;75;75;38;37;0;0;0;43;32;66;9
VII;3396;INFANZIA;COMUNALE;PISCINE DI TORRESPACCATA;Via Marco Dino Rossi, 38;06/7210525;08:00 / 17:00;3;75;75;42;33;0;0;0;43;32;73;2
VII;3392;INFANZIA;COMUNALE;POLLICINO VERDE;Via Di S. Tarcisio, 123;06/7182624;08:00 / 17:00;3;57;56;28;28;0;0;0;38;18;54;2
VII;3399;INFANZIA;COMUNALE;PONTE LINARI;Via Del Muro Linari, 1;06/72671468;08:00 / 17:00;8;178;172;89;83;0;0;0;91;81;159;13
VII;3394;INFANZIA;COMUNALE;PULCE D'ACQUA; Via Lemonia, 228;06/71585300;08:00 / 17:00;5;109;109;54;55;0;0;0;69;40;107;2
VII;3395;INFANZIA;COMUNALE;SALVO D'ACQUISTO;Via Selinunte, 3;06/76963193;08:00 / 17:00;5;125;119;55;64;0;0;0;61;58;97;22
VIII;3583;INFANZIA;COMUNALE;CALEIDOSCOPIO;Viale Del Tintoretto, 365;06/51956576;08:00 / 17:00;3;75;75;39;36;0;0;0;37;38;72;3
VIII;2626;INFANZIA;COMUNALE;CASA DEI BIMBI;Piazza Nicola Longobardi, 2;06/5135132;08:00 / 17:00;9;225;223;120;103;0;0;0;116;107;207;16
VIII;2625;INFANZIA;COMUNALE;COCCINELLA ; Piazza Damiano Sauli, 1;06/5126291;08:00 / 17:00;6;150;150;86;64;0;0;0;88;62;140;10
VIII;3582;INFANZIA;COMUNALE;GESSETTI COLORATI; Viale Del Tintoretto, 301;06/5191928;08:00 / 17:00;3;74;73;31;42;0;0;0;40;33;70;3
VIII;2614;INFANZIA;COMUNALE;GIRASOLE COLORATO ;Via Alessandro Valignano, 54;06/95951106  ;08:00 / 17:00;4;87;86;43;43;0;0;0;49;37;82;4
VIII;2618;INFANZIA;COMUNALE;I MONELLI ;Via Giuseppe Casalinuovo, 32;06/5406856;08:00 / 17:00;3;69;68;36;32;0;0;0;40;28;65;3
VIII;3585;INFANZIA;COMUNALE;IL CASTAGNO;Via Andrea Del Castagno, 175;06/5943024;08:00 / 17:00;2;47;47;23;24;0;0;0;34;13;45;2
VIII;2604;INFANZIA;COMUNALE;IL GELSOMINO;Viale Giustiniano Imperatore, 71;06/5430591;08:00 / 17:00;3;75;75;44;31;0;0;0;40;35;55;20
VIII;3584;INFANZIA;COMUNALE;LA GIOSTRA;Via Di Grotta Perfetta, 524;06/5034876;08:00 / 17:00;3;75;75;45;30;0;0;0;47;28;68;7
VIII;3586;INFANZIA;COMUNALE;LEONARDO DA VINCI ;Viale Leonardo Da Vinci, 96;06/5134326;08:00 / 13:00;2;40;39;22;17;0;0;0;29;10;31;8
VIII;2974;INFANZIA;COMUNALE;LIVIO TEMPESTA ; Via Salvatore Pincherle, 140;06/5576690;08:00 / 17:00;3;63;63;36;27;0;0;0;32;31;55;8
VIII;2611;INFANZIA;COMUNALE;MAPPA...MONDO  ODESC.; Viale Carlo Tommaso Odescalchi, 84;06/5123904;08:00 / 17:00;3;68;67;32;35;0;0;0;47;20;59;8
VIII;2610;INFANZIA;COMUNALE;MAPPA...MONDO GIANG.; Via Francesco Giangiacomo, 5;06/5110456;08:00 / 17:00;4;79;77;44;33;0;0;0;36;41;60;17
VIII;2976;INFANZIA;COMUNALE;PAESE DELLE MERAVIGLIE;Via Antonino Pio, 84;06/;08:00 / 17:00;8;168;164;87;77;0;0;0;92;72;155;9
VIII;3581;INFANZIA;COMUNALE;PICCOLI ESPLORATORI;Via Padre Giuseppe Lais, 9;06/5191235;08:00 / 17:00;5;119;113;58;55;0;0;0;61;52;101;12
VIII;2608;INFANZIA;COMUNALE;PRINCIPE DI PIEMONTE;Via Ostiense, 263A;06/51606358 - 065126052;08:00 / 17:00;9;180;178;92;86;0;0;0;104;74;167;11
VIII;2602;INFANZIA;COMUNALE;RANOCCHIO SCARABOCCHIO ;Viale Erminio Spalla, 36;06/5030580;08:00 / 17:00;10;250;246;131;115;0;0;0;129;117;235;11
VIII;2619;INFANZIA;COMUNALE;TORRE DI BABELE  ;Via Poggio Ameno, 23;06/5403874;08:00 / 17:00;4;77;77;43;34;0;0;0;53;24;70;7
IX;3605;INFANZIA;COMUNALE;AMICO ULIVO;Via Del Pianeta Venere, 110;/;08:00 / 17:00;6;150;139;62;77;0;0;0;76;63;139;0
IX;2963;INFANZIA;COMUNALE;CORNIOLO ROSSO ;Via Ardeatina, 1274;/;08:00 / 17:00;5;106;106;68;38;0;0;0;55;51;90;16
IX;6340;INFANZIA;COMUNALE;FIORE DI LOTO;Viale Gianluigi Bonelli, 201;/;08:00 / 17:00;4;100;83;41;42;0;0;0;26;57;80;3
IX;2817;INFANZIA;COMUNALE;FONTE MERAVIGLIOSA;Via Tommaso Arcidiacono, SNC;/;08:00 / 17:00;4;100;97;56;41;0;0;0;55;42;90;7
IX;2766;INFANZIA;COMUNALE;GIARDINO DEI CILIEGI;Via Ettore Arena, 206;06/95951202;08:00 / 17:00;3;75;73;36;37;0;0;0;43;30;66;7
IX;3618;INFANZIA;COMUNALE;GIARDINO D'EUROPA ;Viale Citta' D'Europa, 345;/;08:00 / 17:00;4;98;76;39;37;0;0;0;43;33;74;2
IX;6424;INFANZIA;COMUNALE;GINKGO DORATO;Via Norma Cossetto, 20;/3666981756;NULL;2;50;39;23;16;0;0;0;9;30;32;7
IX;3616;INFANZIA;COMUNALE;IL CEDRO ARGENTATO;Via Alfonso Di Legge, 32;/;08:00 / 17:00;3;60;58;31;27;0;0;0;29;29;54;4
IX;5662;INFANZIA;COMUNALE;IL FANTABOSCO;Via Federico Alessandrini, 172;/;08:00 / 17:00;3;75;75;37;38;0;0;0;41;34;64;11
IX;3607;INFANZIA;COMUNALE;IL MANDORLO INCANTATO;Viale Citta' D'Europa, 14;/;08:00 / 17:00;4;100;88;47;41;0;0;0;47;41;85;3
IX;2853;INFANZIA;COMUNALE;IL MELO GIROTONDO;Via Antonio Tacconi, 34;/;08:00 / 17:00;3;54;53;27;26;0;0;0;29;24;52;1
IX;2765;INFANZIA;COMUNALE;IL MELOGRANO DEI DESIDERI;Via Giovanni Frignani, 83;/;08:00 / 17:00;3;62;59;31;28;0;0;0;29;30;42;17
IX;3612;INFANZIA;COMUNALE;IL PINO BIRICHINO;Via Beppe Fenoglio, 30;/;08:00 / 17:00;2;50;48;27;21;0;0;0;28;20;36;12
IX;3611;INFANZIA;COMUNALE;IL RISVEGLIO DEL BIANCOSPINO;Via Tomaso Sillani, 24;/;08:00 / 17:00;3;75;62;29;33;0;0;0;35;27;56;6
IX;3614;INFANZIA;COMUNALE;IL TIGLIO INCANTATO;Via Orazio Console, 35;/;08:00 / 17:00;3;66;60;37;23;0;0;0;33;27;53;7
IX;3606;INFANZIA;COMUNALE;L' ALBERO DEI TULIPANI;Via Dell'Elettronica, 3;/;08:00 / 17:00;3;60;60;35;25;0;0;0;27;33;54;6
IX;2784;INFANZIA;COMUNALE;L' ALLEGRO SALICE;Via Marzabotto, 14;/;08:00 / 17:00;5;104;104;55;49;0;0;0;57;47;92;12
IX;3613;INFANZIA;COMUNALE;L' ARANCIO GOLOSO;Viale Luca Gaurico, 231;/;08:00 / 17:00;3;72;71;44;27;0;0;0;37;34;63;8
IX;2772;INFANZIA;COMUNALE;LA BETULLA MAGICA;Via Di Trigoria, 280;/;08:00 / 13:20;2;40;34;15;19;0;0;0;14;20;32;2
IX;2770;INFANZIA;COMUNALE;LA FATA CAMELIA;Via Nicola Stame, 162;/;08:00 / 17:00;2;50;44;27;17;0;0;0;29;15;41;3
IX;3617;INFANZIA;COMUNALE;LA GRANDE QUERCIA;Via Giuseppe Marotta, 30;/;08:00 / 17:00;3;75;74;38;36;0;0;0;44;30;49;25
IX;3832;INFANZIA;COMUNALE;LA MAGA MELIA;Via Alberto Moravia, 280;/;08:00 / 17:00;4;100;97;56;41;0;0;0;43;54;96;1
IX;2773;INFANZIA;COMUNALE;LA MAGNOLIA STELLATA;Via Augusto Renzini, 22;/;08:00 / 17:00;2;43;41;19;22;0;0;0;26;15;33;8
IX;3833;INFANZIA;COMUNALE;LA MIMOSA BIRICHINA 1;Via Bruno De Finetti, 172;/;08:00 / 17:00;3;75;75;33;42;0;0;0;47;28;75;0
IX;5749;INFANZIA;COMUNALE;LA MIMOSA BIRICHINA 2;Via Giusto Bellavitis, SNC;/;08:00 / 16:30;2;50;49;34;15;0;0;0;37;12;49;0
IX;5877;INFANZIA;COMUNALE;LA PIMPA ;Viale Luigi Guglielmi, 91;/;08:00 / 17:00;6;150;150;71;79;0;0;0;83;67;147;3
IX;3615;INFANZIA;COMUNALE;LA SCUOLA DEI LILLA';Via Renato Togni, SNC;/;08:00 / 13:20;2;40;28;18;10;0;0;0;15;13;27;1
IX;3610;INFANZIA;COMUNALE;LA VALLETTA INCANTATA;Via Carlo Emilio Gadda, 156;/;08:00 / 17:00;6;150;150;86;64;0;0;0;72;78;145;5
IX;5521;INFANZIA;COMUNALE;LO CHALET DEL SOLE;Via Gemmano, 14;/;08:00 / 17:00;2;50;49;27;22;0;0;0;29;20;38;11
IX;2769;INFANZIA;COMUNALE;MAGICA MAGNOLIA;Via Raffaele Aversa, 165;06/95951203;08:00 / 17:00;3;75;63;32;31;0;0;0;31;32;57;6
IX;2771;INFANZIA;COMUNALE;PICCOLO MANDARINO;Via Filippo De Grenet, SNC;06/95951205;08:00 / 17:00;3;75;75;34;41;0;0;0;43;32;70;5
IX;2820;INFANZIA;COMUNALE;PRATO SMERALDO;Via Benedetto Rogacci, 35;/;08:00 / 17:00;3;75;71;42;29;0;0;0;48;23;67;4
X;3956;INFANZIA;COMUNALE;ARABA FENICE;Via Licinio Refice, 50;/;08:00 / 17:00;4;97;97;45;52;0;0;0;64;33;90;7
X;2710;INFANZIA;COMUNALE;AURORA;Via Giuliano Da Sangallo, 15;06/5613240;08:00 / 17:00;1;25;25;9;16;0;0;0;16;9;21;4
X;3413;INFANZIA;COMUNALE;BORGO ANTICO;Via Pericle Ducati, 12;06/56352771;NULL;2;28;28;11;17;0;0;0;17;11;25;3
X;3414;INFANZIA;COMUNALE;DO-RE-MI DIVERTO; Via Della Tortuga, 9;/;08:00 / 17:00;4;92;92;48;44;0;0;0;55;37;72;20
X;2686;INFANZIA;COMUNALE;DRAGOLANDIA;Via Monvalle, 45;06/5219647;08:00 / 17:00;5;124;124;75;49;0;0;0;72;52;111;13
X;5673;INFANZIA;COMUNALE;GABBIANELLA AL PORTO;Via Domenico Baffigo, 145/165;/;08:00 / 17:00;9;225;224;125;99;0;0;0;124;100;211;13
X;2693;INFANZIA;COMUNALE;GLI EUCALIPTI;Via Capo Delle Armi, 80;06/5682496;08:00 / 17:00;4;82;82;43;39;0;0;0;55;27;75;7
X;3971;INFANZIA;COMUNALE;I PIRATI DEL MAR ROSSO;Via Mar Rosso, 334;/;NULL;3;75;75;31;44;0;0;0;45;30;74;1
X;2690;INFANZIA;COMUNALE;IL CUCCIOLO;Via Torcegno, 19;06/50913352;08:00 / 17:00;8;193;193;101;92;0;0;0;125;68;180;13
X;3406;INFANZIA;COMUNALE;IL GIARDINO DI SARA;Via Costantino Beschi, 23;06/52358088;08:00 / 17:00;5;100;100;46;54;0;0;0;82;18;79;21
X;3411;INFANZIA;COMUNALE;IL PINETO;Largo Delle Marianne, 14;06/5693257;NULL;4;93;93;49;44;0;0;0;47;46;86;7
X;2687;INFANZIA;COMUNALE;IL POGGIO;Via Del Poggio Di Acilia, 24;06/52363338;08:00 / 17:00;3;75;75;40;35;0;0;0;53;22;64;11
X;2696;INFANZIA;COMUNALE;ISOLE AZZORRE;Via Delle Azzorre, 314;/;08:00 / 17:00;6;144;144;86;58;0;0;0;65;79;128;16
X;2695;INFANZIA;COMUNALE;L'ALBERO VANITOSO;Via Caterina Segurana, 2;/;08:00 / 17:00;4;82;82;44;38;0;0;0;40;42;67;15
X;3407;INFANZIA;COMUNALE;MIRO';Via Bepi Romagnoni, 90;06/52311913;08:00 / 17:00;3;75;75;37;38;0;0;0;49;26;67;8
X;3416;INFANZIA;COMUNALE;NOI ARCOBALENO; Via Pietro Ercole Visconti, 7;06/5694796;NULL;6;117;117;64;53;0;0;0;67;50;99;18
X;2688;INFANZIA;COMUNALE;PEGASO;Via Francesco Menzio, 399;/;08:00 / 17:00;2;50;50;32;18;0;0;0;44;6;49;1
X;3844;INFANZIA;COMUNALE;PESCE MAGICO;Via Piero Gherardi, 39;/;08:00 / 17:00;2;50;50;27;23;0;0;0;33;17;43;7
X;2694;INFANZIA;COMUNALE;QUINQUEREMI COMUNALE;Via Delle Quinqueremi, 23;06/56320018;08:00 / 17:00;7;175;175;96;79;0;0;0;108;67;165;10
X;3405;INFANZIA;COMUNALE;RAFFAELLA LA CROCIERA ;Via Guido Biagi, 45;/;08:00 / 17:00;5;101;101;53;48;0;0;0;83;18;91;10
X;3410;INFANZIA;COMUNALE;RAGGIODISOLE;Via Eupoli, 101;/;NULL;5;100;100;53;47;0;0;0;50;50;98;2
X;3845;INFANZIA;COMUNALE;SOLE LUNA;Via Giorgio De Lullo, 98;06/52440405;08:00 / 17:00;4;100;100;55;45;0;0;0;61;39;94;6
X;2685;INFANZIA;COMUNALE;SOLLETICO; Via Monvalle, 61;/;08:00 / 17:00;3;75;75;34;41;0;0;0;40;35;73;2
X;2691;INFANZIA;COMUNALE;STELLA DEL MARE;Via Mar Dei Caraibi, 28;/;08:00 / 17:00;6;150;150;72;78;0;0;0;83;67;146;4
X;3594;INFANZIA;COMUNALE;STELLE NASCENTI ;Via Nora Ricci, 30;06/5258108;08:00 / 17:00;3;75;75;37;38;0;0;0;44;31;73;2
X;2709;INFANZIA;COMUNALE;TOR SAN MICHELE;Via Della Tortuga, 11;/;08:00 / 17:00;4;100;100;50;50;0;0;0;52;48;92;8
X;3408;INFANZIA;COMUNALE;ZUCCHERO FILATO ;Via Nino Taranto, 70;06/52440319;08:00 / 17:00;5;125;124;61;63;0;0;0;59;65;120;4
XI;3577;INFANZIA;COMUNALE; PESCAGLIA ;Via Pescaglia, 75;06/5501549;08:00 / 13:00;3;69;66;35;31;0;0;0;46;20;46;20
XI;2743;INFANZIA;COMUNALE;BENUCCI;Via Ignazio Ribotti, 45;06/55266947;08:00 / 17:00;6;150;145;76;69;0;0;0;76;69;132;13
XI;3182;INFANZIA;COMUNALE;BRUNO CIARI ;Via Dei Sampieri, 58;06/6557244;08:00 / 17:00;4;100;100;57;43;0;0;0;52;48;96;4
XI;3153;INFANZIA;COMUNALE;CITTADINI DEL MONDO;Via Di S. Pantaleo Campano, 41;06/6533676;08:00 / 17:00;3;75;70;43;27;0;0;0;33;37;64;6
XI;3150;INFANZIA;COMUNALE;COLLODI 1;Via Massa Marittima, 1;06/6538953;08:00 / 17:00;3;75;75;42;33;0;0;0;37;38;50;25
XI;3147;INFANZIA;COMUNALE;GIROTONDO DELL'AMICIZIA;Via Alessandro Cruto, 41;06/5578995;08:00 / 17:00;6;135;130;69;61;0;0;0;80;50;108;22
XI;6140;INFANZIA;COMUNALE;GRAZIOSI;Via Greve, 105;06/5500794;08:00 / 17:00;2;50;39;19;20;0;0;0;27;12;28;11
XI;3174;INFANZIA;COMUNALE;GREVE;Via Greve, 41;06/55267853;08:00 / 17:00;6;150;144;70;74;0;0;0;82;62;114;30
XI;3154;INFANZIA;COMUNALE;GULLIVER;Via Ignazio Ribotti, 71;06/55265874;08:00 / 17:00;4;86;86;51;35;0;0;0;54;32;81;5
XI;3156;INFANZIA;COMUNALE;IL CASTELLO INCANTATO;Via Luigi Solidati Tiburzi, 2;06/55130371;08:00 / 17:00;6;130;123;59;64;0;0;0;58;65;105;18
XI;3146;INFANZIA;COMUNALE;IL MELOGRANO ;Via Dei Papareschi, 28A;06/55369588 - 5593622;08:00 / 17:00;5;100;91;55;36;0;0;0;50;41;64;27
XI;3376;INFANZIA;COMUNALE;LA COCCINELLA CURIOSA;Via Portuense, 1418;06/65000851;08:00 / 17:00;5;125;125;53;72;0;0;0;72;53;112;13
XI;3151;INFANZIA;COMUNALE;LA TORTA IN CIELO DI GIANNI RODARI ;Via Giovanni Porzio, 30;06/6534739;08:00 / 17:00;3;60;60;26;34;0;0;0;39;21;59;1
XI;3155;INFANZIA;COMUNALE;LO SCARABOCCHIO;Via Domenico Lupatelli, 5;06/55287434;08:00 / 17:00;7;161;160;81;79;0;0;0;101;59;149;11
XI;3176;INFANZIA;COMUNALE;MARIA DE MATTIAS;Via Pian Due Torri, 110;06/95951563;08:00 / 17:00;5;125;121;61;60;0;0;0;58;63;97;24
XI;3148;INFANZIA;COMUNALE;MONDO INCANTATO;Via Pietro Blaserna, 43;06/55309682;08:00 / 17:00;5;97;96;54;42;0;0;0;57;39;88;8
XI;3181;INFANZIA;COMUNALE;PLACIDO MARTINI;Via Della Casetta Mattei, 269;06/6555022;08:00 / 17:00;6;128;125;66;59;0;0;0;69;56;108;17
XI;6417;INFANZIA;COMUNALE;PONTE GALERIA;Via Giuseppe Albenga, SNC;/;08:00 / 17:00;2;50;50;24;26;0;0;0;27;23;37;13
XI;3157;INFANZIA;COMUNALE;VACCARI ;Viale Di Vigna Pia, 120;06/55368289;08:00 / 17:00;10;195;192;97;95;0;0;0;121;71;169;23
XII;2915;INFANZIA;COMUNALE;ANGELO CELLI ; Via Dei Torriani, 44;06/6636754;08:00 / 17:00;6;146;135;71;64;0;0;0;76;59;115;20
XII;2914;INFANZIA;COMUNALE;BUON PASTORE ;Via Di Bravetta, 336;06/66153982;08:00 / 17:00;4;100;100;48;52;0;0;0;58;42;83;17
XII;2881;INFANZIA;COMUNALE;CARLO FORLANINI ; Piazza Carlo Forlanini, 8;06/58201435;08:00 / 17:00;6;137;137;75;62;0;0;0;86;51;123;14
XII;3578;INFANZIA;COMUNALE;FANTASIA DI COLORI ;Via Giuseppe Balzaretto, 68;06/66541776;08:00 / 17:00;2;50;50;23;27;0;0;0;17;33;46;4
XII;2878;INFANZIA;COMUNALE;FRANCESCO CRISPI INFANZIA;Via Anton Giulio Barrili, 15;06/5896084;08:00 / 17:00;7;167;165;87;78;0;0;0;92;73;158;7
XII;2879;INFANZIA;COMUNALE;GIORGIO FRANCESCHI ; Via Di Donna Olimpia, 45;06/5349993;08:00 / 17:00;7;175;173;93;80;0;0;0;90;83;145;28
XII;2880;INFANZIA;COMUNALE;GUGLIELMO OBERDAN ;Largo Alessandrina Ravizza, 2;06/5374173;08:00 / 17:00;7;175;175;97;78;0;0;0;96;79;156;19
XII;2913;INFANZIA;COMUNALE;IL PAESE DEI BALOCCHI ;Via Raimondo D'Aronco, 28;06/66541636;08:00 / 17:00;3;75;75;42;33;0;0;0;37;38;71;4
XII;2883;INFANZIA;COMUNALE;ISACCO ARTOM ;Via Isacco Artom, 141;06/65743705;08:00 / 17:00;4;96;96;54;42;0;0;0;39;57;86;10
XII;6185;INFANZIA;COMUNALE;LICIO GIORGERI;Via Licio Giorgieri, 58;06/66416528;08:00 / 16:30;1;25;25;10;15;0;0;0;14;11;19;6
XII;2884;INFANZIA;COMUNALE;LOLA DI STEFANO ;Via Alessandro Crivelli, 24;06/53279700;08:00 / 17:00;5;110;109;59;50;0;0;0;74;35;98;11
XII;2882;INFANZIA;COMUNALE;VICTOR HUGO GIROLAMI ;Via Casimiro Manassei, 60;06/65741764;08:00 / 17:00;4;87;87;41;46;0;0;0;49;38;80;7
I;3116;INFANZIA;COMUNALE; LUIGI PIANCIANI;Via Del Falco, 3;06/6865001;08:00 / 16:30;6;140;129;72;57;0;0;0;68;61;122;7
I;2886;INFANZIA;COMUNALE;ADELAIDE CAIROLI;Via Giordano Bruno, 2;06/39738646;08:00 / 17:00;9;217;197;94;103;0;0;0;121;76;165;32
I;2891;INFANZIA;COMUNALE;ERMENEGILDO PISTELLI;Via Monte Zebio, 33;06/37352114;08:00 / 17:00;8;200;200;93;107;0;0;0;121;79;196;4
I;2888;INFANZIA;COMUNALE;GIOVAN  BATTISTA VICO;Piazzale Degli Eroi, 14;06/39720008;08:00 / 17:00;10;250;238;126;112;0;0;0;137;101;200;38
I;2890;INFANZIA;COMUNALE;UMBERTO I;Via Boezio, 1;06/6876705;08:00 / 17:00;7;175;160;67;93;0;0;0;86;74;143;17
I;2885;INFANZIA;COMUNALE;17 GIACOMO LEOPARDI;Parco Della Vittoria, 30;06/35343293;08:00 / 17:00;9;195;183;100;83;0;0;0;100;83;182;1
I;3620;INFANZIA;COMUNALE;19 GIACOMO LEOPARDI;Parco Della Vittoria, 30;/;08:00 / 17:00;1;17;0;0;0;0;0;0;0;0;0;0
XIII;2893;INFANZIA;COMUNALE; IL CIELO STELLATO EX 2 OTTOBRE 1870 - ;Piazza Di S. Maria Alle Fornaci, 3;06/636814;08:00 / 17:00;5;122;102;51;51;0;0;0;56;46;89;13
XIII;3491;INFANZIA;COMUNALE;ALBERTO SORDI ;Via Villadossola, SNC;06/6244676;08:00 / 17:00;4;100;99;49;50;0;0;0;52;47;92;7
XIII;2900;INFANZIA;COMUNALE;ALFREDO BAIOCCO 259 ;Via Di Casalotti, 259;06/61561936;08:00 / 17:00;6;148;148;72;76;0;0;0;100;48;135;13
XIII;3431;INFANZIA;COMUNALE;ANDREA BALDI ;Via Sisto Iv, 176;06/6148740;08:00 / 17:00;4;100;88;49;39;0;0;0;52;36;75;13
XIII;3435;INFANZIA;COMUNALE;CARLO EVANGELISTI ;Via Cornelia, 75E;06/61522780;08:00 / 17:00;6;150;148;76;72;0;0;0;82;66;120;28
XIII;3439;INFANZIA;COMUNALE;CASTEL DI GUIDO;Via Gaetano Sodini, 25;06/6689232;08:00 / 17:00;2;46;43;20;23;0;0;0;19;24;42;1
XIII;5565;INFANZIA;COMUNALE;COLLINA DELLE MUSE ;Via Aldo Spallicci, 31;06/96668386;08:00 / 17:00;3;75;75;37;38;0;0;0;48;27;72;3
XIII;2896;INFANZIA;COMUNALE;FILASTROCCA IMPERTINENTE ;Via Francesco Albergotti, 29;06/6620414;08:00 / 17:00;3;75;75;46;29;0;0;0;38;37;66;9
XIII;5511;INFANZIA;COMUNALE;I PICCOLI GIRASOLI ;Via Luca Passi, 55;06/66514496;08:00 / 17:00;6;150;148;85;63;0;0;0;72;76;131;17
XIII;3433;INFANZIA;COMUNALE;IL BOSCO INCANTATO ;Via Di Boccea, 590;06/61566997;08:00 / 17:00;4;80;80;40;40;0;0;0;51;29;57;23
XIII;2897;INFANZIA;COMUNALE;IL GIARDINO DELLE IDEE ;Via Francesco Schupfer, 62;06/66016984;08:00 / 17:00;3;75;71;33;38;0;0;0;41;30;69;2
XIII;2928;INFANZIA;COMUNALE;LA LUNA SAPIENTE (EX LIVIO TEMPESTA);Via Di Casalotti, 87;06/61569560;08:00 / 17:00;4;100;100;53;47;0;0;0;68;32;95;5
XIII;3453;INFANZIA;COMUNALE;LA PUNTA ;Via Pietro De Francisci, 737;06/66415799;08:00 / 17:00;3;75;71;39;32;0;0;0;38;33;69;2
XIII;2895;INFANZIA;COMUNALE;MANETTI ;Via Giannozzo Manetti, 6;06/39377550;08:00 / 17:00;4;100;95;49;46;0;0;0;47;48;85;10
XIII;3457;INFANZIA;COMUNALE;MILLECOLORI ;Via Gregorio Xi, 260;06/66416009;08:00 / 17:00;3;75;75;44;31;0;0;0;44;31;72;3
XIII;2901;INFANZIA;COMUNALE;PADRE BERNARDINO MASTROIANNI ;Via Ponzone, 23;06/61908020;08:00 / 17:00;4;100;100;64;36;0;0;0;61;39;95;5
XIII;2892;INFANZIA;COMUNALE;S. FRANCESCO D'ASSISI ;Piazza Francesco Borgongini Duca, 5;06/39638360;08:00 / 17:00;7;171;166;83;83;0;0;0;104;62;155;11
XIII;3427;INFANZIA;COMUNALE;SCINTILLE DI FANTASIA (GIA' ALFREDO BAIOCCO 85) ;Via Di Casalotti, 85;06/61562055;08:00 / 17:00;6;150;150;83;67;0;0;0;84;66;131;19
XIII;3467;INFANZIA;COMUNALE;VITTORIO ALFIERI ;Largo S. Pio V, 21;06/6636002;08:00 / 17:00;5;125;125;67;58;0;0;0;79;46;115;10
XIV;2940;INFANZIA;COMUNALE;ANDERSEN;Via Del Podere Trieste, 20;06/6278745;07:30 / 16:30;5;125;125;69;56;0;0;0;72;53;119;6
XIV;2942;INFANZIA;COMUNALE;CALASANZIO;Via Ottavio Assarotti, 11;06/3385113;08:00 / 17:00;4;86;86;50;36;0;0;0;50;36;55;31
XIV;5728;INFANZIA;COMUNALE;CAMILLA RAVERA;Via Vivi Gioi, 27;/;08:00 / 17:00;3;75;75;37;38;0;0;0;24;51;73;2
XIV;2943;INFANZIA;COMUNALE;C'ERA UNA VOLTA ;Via Leonardo Bianchi, 40;06/30601219;08:00 / 17:00;8;200;200;99;101;0;0;0;103;97;151;49
XIV;2936;INFANZIA;COMUNALE;CESARE NOBILI ;Via Della Balduina, 281;06/35454027;08:00 / 17:00;6;118;118;61;57;0;0;0;65;53;110;8
XIV;2933;INFANZIA;COMUNALE;IL GIRASOLE ;Via Giuseppe Taverna, 95;06/3054942;08:00 / 17:00;6;130;130;68;62;0;0;0;70;60;119;11
XIV;3572;INFANZIA;COMUNALE;IL PINGUINO DAMERINO;Via Alessio Ascalesi, 2;06/61663029;08:00 / 17:00;3;66;65;34;31;0;0;0;32;33;44;21
XIV;2939;INFANZIA;COMUNALE;LA GATTA TURCHINA ;Via Giambattista Soria, 73;06/6276869;08:00 / 17:00;3;71;71;42;29;0;0;0;32;39;60;11
XIV;2931;INFANZIA;COMUNALE;LAMBRUSCHINI;Via Suor Celestina Donati, 110;06/3014640;08:00 / 17:00;8;155;152;86;66;0;0;0;83;69;140;12
XIV;2935;INFANZIA;COMUNALE;LATTANZIO;Via Lattanzio, 10;06/39735278;08:00 / 17:00;4;84;84;44;40;0;0;0;51;33;77;7
XIV;2929;INFANZIA;COMUNALE;L.L. BESSO  ;Via Di Casal Del Marmo, 118;06/30814789;08:00 / 17:00;13;325;325;171;154;0;0;0;195;130;272;53
XIV;2941;INFANZIA;COMUNALE;MAGICAMENTE;Via Di Boccea, 590;06/61551148;08:00 / 13:20;4;85;83;46;37;0;0;0;42;41;72;11
XIV;2930;INFANZIA;COMUNALE;MONTE ARSICCIO ;Via Domenico Ciampoli, 15;06/30814744;08:00 / 17:00;4;74;72;45;27;0;0;0;44;28;55;17
XIV;2934;INFANZIA;COMUNALE;NAZARIO SAURO;Via Trionfale, 7333;06/3054168;08:00 / 17:00;4;79;79;36;43;0;0;0;46;33;48;31
XIV;2937;INFANZIA;COMUNALE;P. MAFFI;Via Pietro Maffi, 45;06/3070586;08:00 / 17:00;5;110;110;55;55;0;0;0;66;44;85;25
XIV;3655;INFANZIA;COMUNALE;TAGGIA ;Via Taggia, 70;06/35500493;08:00 / 17:00;6;120;119;59;60;0;0;0;67;52;110;9
XIV;2938;INFANZIA;COMUNALE;UMBERTO CERBONI;Via Federico Borromeo, 69;06/61432901;08:00 / 17:00;5;117;115;65;50;0;0;0;64;51;93;22
XV;2959;INFANZIA;COMUNALE;ANGELINI ;Via Alfredo Sforzini, 40;06/3039139;08:00 / 17:00;7;175;175;95;80;0;0;0;92;83;117;58
XV;6420;INFANZIA;COMUNALE;CASE E CAMPI;Via Carlo Gherardini, 67;/;08:00 / 17:00;4;100;100;59;41;0;0;0;68;32;93;7
XV;2950;INFANZIA;COMUNALE;FERRANTE APORTI ;Via Antonio Serra, 91;06/3340180;08:00 / 17:00;7;153;151;74;77;0;0;0;74;77;128;23
XV;2960;INFANZIA;COMUNALE;G.SOGLIAN;Largo Cesare Vico Lodovici, 5;06/3088564;08:00 / 17:00;5;112;112;63;49;0;0;0;66;46;96;16
XV;2958;INFANZIA;COMUNALE;IL BRUCHETTO;Via Giuseppe Silla, 33;06/30365653;08:00 / 17:00;4;100;101;52;49;0;0;0;47;54;84;17
XV;2948;INFANZIA;COMUNALE;IL TRENINO  (EX COLLI D'ORO) ;Largo Foppolo, 11;06/33613151;08:00 / 17:00;4;99;99;49;50;0;0;0;44;55;89;10
XV;3025;INFANZIA;COMUNALE;LA MIMOSA;Via Concesio, 13;06/33611970;08:00 / 17:00;3;75;74;46;28;0;0;0;51;23;68;6
XV;2945;INFANZIA;COMUNALE;L'AQUILONE;Via Baccano, 10;06/33610957;08:00 / 17:00;4;84;82;41;41;0;0;0;45;37;66;16
XV;2944;INFANZIA;COMUNALE;L'ARCOBALENO;Via San Daniele Del Friuli, SNC;06/33611795;08:00 / 17:00;4;100;100;53;47;0;0;0;59;41;98;2
XV;2957;INFANZIA;COMUNALE;L'ISOLA FELICE;Via Di Tragliatella, 86;06/3046109;08:00 / 13:00;3;75;72;40;32;0;0;0;39;33;68;4
XV;2952;INFANZIA;COMUNALE;MENGOTTI;Via Francesco Mengotti, 24;06/36304956;08:00 / 17:00;4;87;86;51;35;0;0;0;43;43;77;9
XV;2949;INFANZIA;COMUNALE;MERELLI;Via Giacomo Malvano, 20;06/3331397;08:00 / 17:00;4;100;99;53;46;0;0;0;61;38;73;26
XV;2953;INFANZIA;COMUNALE;PARCO DI VEIO;Via Fosso Del Fontaniletto, 29B;06/33264986;08:00 / 17:00;6;132;131;70;61;0;0;0;68;63;93;38
XV;2956;INFANZIA;COMUNALE;PETER PAN;Via Primo Dorello, 8;06/30895379;08:00 / 17:00;3;75;75;40;35;0;0;0;48;27;69;6
XV;2955;INFANZIA;COMUNALE;SAN GODENZO;Via San Godenzo, 200;06/3351172;08:00 / 17:00;2;50;47;24;23;0;0;0;28;19;32;15
XV;5770;INFANZIA;COMUNALE;SAXA RUBRA;Via Di Quarto Peperino, 31;06/0633680077;NULL;2;50;50;25;25;0;0;0;32;18;48;2
XV;2954;INFANZIA;COMUNALE;VIBIO MARIANO;Via Vibio Mariano, 105;06/33266389;08:00 / 17:00;3;60;53;28;25;0;0;0;24;29;28;25
XV;2951;INFANZIA;COMUNALE;ZANDONAI;Via Riccardo Zandonai, 118;06/36309954;08:00 / 17:00;8;164;160;87;73;0;0;0;83;77;150;10
Totali;;;;;;;;1.500;34.717;33.606;17.514;16.092;0;0;0;18.971;14.635;29.540;4.066
